11111111
1P0001C1
10000001
1C101001
100C0001
111111E1
11111111
