1111111111111
1P0N0100010C1
1100C001C00N1
10N010N001001
10C0000C00001
11111C0NC0NE1
1111111111111
